1111111111111111111111111111111111
1E000000000000000CCC0000C0000000P1
1111111111111111111111111111111111
1111111111111111111111111111111111
1111111111111111111111111111111111
1111111111111111111111111111111111
