1111111111111111111111111111111111
1E0000000000000000000000C0000000P1
1111111111111111111111111111111111
1111111111111111111111111111111111
1111111111111111111111111111111111
1111111111111111111111111111111111
