11111
1P0E1
1CCC1
1P001
11111
