11111
1P0E1
1CCC1
1E001
11111
