111111111111111111111111111111111111111111111111
1111000CCCECCCCCC0000000000000000000PCCCCCCCC111
111111111111111111111111111111111111111111111111
111111111111111111111111111111111111111111111111
111111111111111111111111111111111111111111111111