11111P11111C1
1000001000101
1011101010C01
1C10000001101
1000111100001
1010111100111
1010011C00001
10C1011111001
11110000C10E1