1111111111111
1000P01000101
1011101010C01
1C10000001101
1000111100001
101011110011C
1010011C0E001
10C1011111001
1111111111111